M,0,0,0,0,0
0,0,0,0,0,0
0,*,0,0,0,0
0,0,0,0,0,0
0,0,0,0,0,0
0,0,*,0,0,0
0,0,0,0,0,0
0,0,0,0,*,0
0,0,0,*,0,0
0,0,0,0,0,*
0,*,0,0,0,0
0,0,0,*,0,0
0,0,0,0,0,0
0,0,0,0,*,0
*,0,0,0,0,0
0,0,0,0,0,0
0,0,0,0,0,X
